8 8
1 1 1 1 1 1 1 1  
1 0 0 0 0 0 0 0 
1 0 0 0 4 0 0 0 
1 0 0 0 4 4 1 0
1 0 0 0 1 0 0 0
1 0 0 0 1 0 0 0 
1 0 0 0 1 0 0 0
1 2 0 0 4 3 0 0
